StatelyGardens
An Interactive Fiction by Kaylah Facey
Release 1 / Serial number 240813 / Inform 7 v10.1.2 / D

This game uses tank movement commands. Use WS to move forward and back, and AD to turn right and left without moving. To quit, press Q.

You can't go any further that way.

You are .
Directly in front of you: There is nothing of note.
Further to the front: There is nothing of note.
Directly to your left: There is nothing of note.
Further to the left: There is nothing of note.
Directly to your right: There is nothing of note.
Further to the right: There is nothing of note.

* * *

>d
You can't go that way.

>d
You can't go that way.

* * *

StatelyGardens
An Interactive Fiction by Kaylah Facey
Release 1 / Serial number 240813 / Inform 7 v10.1.2 / D

This game uses tank movement commands. Use WS to move forward and back, and AD to turn right and left without moving. To quit, press Q.

You can't go any further that way.

You are .
Directly in front of you: There is nothing of note.
Further to the front: There is nothing of note.
Directly to your left: There is nothing of note.
Further to the left: There is nothing of note.
Directly to your right: There is nothing of note.
Further to the right: There is nothing of note.

>ddd
That's not a verb I recognise.

* * *

I beg your pardon?

* * *

>sddf
That's not a verb I recognise.

I beg your pardon?

I beg your pardon?

* * *

StatelyGardens
An Interactive Fiction by Kaylah Facey
Release 1 / Serial number 240813 / Inform 7 v10.1.2 / D

This game uses tank movement commands. Use WS to move forward and back, and AD to turn right and left without moving. To quit, press Q.

You can't go any further that way.

You are .
Directly in front of you: There is nothing of note.
Further to the front: There is nothing of note.
Directly to your left: There is nothing of note.
Further to the left: There is nothing of note.
Directly to your right: There is nothing of note.
Further to the right: There is nothing of note.

>dddddd
That's not a verb I recognise.

>c
That's not a verb I recognise.

>asdfasdf
That's not a verb I recognise.

* * *

StatelyGardens
An Interactive Fiction by Kaylah Facey
Release 1 / Serial number 240813 / Inform 7 v10.1.2 / D

This game uses tank movement commands. Use WS to move forward and back, and AD to turn right and left without moving. To quit, press Q.

You can't go any further that way.

You are .
Directly in front of you: There is nothing of note.
Further to the front: There is nothing of note.
Directly to your left: There is nothing of note.
Further to the left: There is nothing of note.
Directly to your right: There is nothing of note.
Further to the right: There is nothing of note.

>f
That's not a verb I recognise.

>dasdf
That's not a verb I recognise.

* * *

StatelyGardens
An Interactive Fiction by Kaylah Facey
Release 1 / Serial number 240813 / Inform 7 v10.1.2 / D

This game uses tank movement commands. Use WS to move forward and back, and AD to turn right and left without moving. To quit, press Q.

You can't go any further that way.

You are .
Directly in front of you: There is nothing of note.
Further to the front: There is nothing of note.
Directly to your left: There is nothing of note.
Further to the left: There is nothing of note.
Directly to your right: There is nothing of note.
Further to the right: There is nothing of note.

>rules on
Rules tracing now switched on. Type "rules off" to switch it off again, or "rules all" to include even rules which do not apply.

[Rule "parse command rule" applies.]
[Rule "print notifications fallback rule" applies.]
[Rule "empty displayed notifications list rule" applies.]
[Rule "convert default prompt to Vorple prompt rule" applies.]

>actions on
[Rule "declare everything initially unmentioned rule" applies.]
[Rule "generate action rule" applies.]
Actions listing on.

[Rule "parse command rule" applies.]
[Rule "print notifications fallback rule" applies.]
[Rule "empty displayed notifications list rule" applies.]
[Rule "convert default prompt to Vorple prompt rule" applies.]

>d
[Rule "timed events rule" applies.]
[Rule "advance time rule" applies.]
[Rule "update chronological records rule" applies.]
[Rule "A last turn sequence rule" applies.]
[Rule "scene change machinery rule" applies.]
[Rule "adjust light rule" applies.]
[Rule "note object acquisitions rule" applies.]
[Rule "notify score changes rule" applies.]
[Rule "parse command rule" applies.]
[Rule "print notifications fallback rule" applies.]
[Rule "empty displayed notifications list rule" applies.]
[Rule "convert default prompt to Vorple prompt rule" applies.]